"regions_onscreen_acadia"	"Acadia"	"False"
"regions_onscreen_afghanistan"	"Afghanistan"	"False"
"regions_onscreen_ahmadnagar"	"Ahmadnagar"	"False"
"regions_onscreen_algiers"	"Algiers"	"False"
"regions_onscreen_algonquin_territory"	"Algonquin Territory"	"False"
"regions_onscreen_alsace"	"Alsace-Lorraine"	"False"
"regions_onscreen_amazonas"	"Amazonia"	"False"
"regions_onscreen_anatolia"	"Anatolia"	"False"
"regions_onscreen_arabia"	"Arabia"	"False"
"regions_onscreen_arkhangelsk"	"Arkhangelsk"	"False"
"regions_onscreen_armenia"	"Armenia"	"False"
"regions_onscreen_astrakhan"	"Astrakhan"	"False"
"regions_onscreen_austria"	"Austria"	"False"
"regions_onscreen_azerbaijan"	"Azerbaijan"	"False"
"regions_onscreen_bahamas"	"Bahamas"	"False"
"regions_onscreen_baluchistan"	"Baluchistan"	"False"
"regions_onscreen_bashkira"	"Bashkiria"	"False"
"regions_onscreen_bavaria"	"Bavaria"	"False"
"regions_onscreen_belarus"	"Belarus & Volhynia"	"False"
"regions_onscreen_bengal"	"Bengal"	"False"
"regions_onscreen_berar"	"Berar"	"False"
"regions_onscreen_bijapur"	"Bijapur"	"False"
"regions_onscreen_bohemia"	"Bohemia & Moravia"	"False"
"regions_onscreen_bosnia"	"Bosnia"	"False"
"regions_onscreen_bulgaria"	"Bulgaria"	"False"
"regions_onscreen_carnatica"	"Carnatica"	"False"
"regions_onscreen_carolinas"	"Carolinas"	"False"
"regions_onscreen_central_africa"	"Central Africa"	"False"
"regions_onscreen_ceylon"	"Ceylon"	"False"
"regions_onscreen_chechenya-dagestan"	"Chechenya-Dagestan"	"False"
"regions_onscreen_chechenya-dagestan"	"Hazaria"	"False"
"regions_onscreen_cherokee_territory"	"Cherokee Territory"	"False"
"regions_onscreen_china"	"Empire of China"	"False"
"regions_onscreen_congo_impassable"	"Congo"	"False"
"regions_onscreen_corsica"	"Corsica"	"False"
"regions_onscreen_courland"	"Courland"	"False"
"regions_onscreen_crimea"	"Crimea"	"False"
"regions_onscreen_croatia"	"Croatia"	"False"
"regions_onscreen_cuba"	"Cuba"	"False"
"regions_onscreen_curacao"	"Curaçao"	"False"
"regions_onscreen_denmark"	"Denmark"	"False"
"regions_onscreen_don_voisko"	"Don Voisko"	"False"
"regions_onscreen_dutch_guyana"	"Dutch Guyana"	"False"
"regions_onscreen_east_africa"	"East Africa"	"False"
"regions_onscreen_egypt"	"Egypt"	"False"
"regions_onscreen_england"	"England"	"False"
"regions_onscreen_estonia_and_livonia"	"Estonia & Livonia"	"False"
"regions_onscreen_finland"	"Finland"	"False"
"regions_onscreen_flanders"	"Flanders"	"False"
"regions_onscreen_florida"	"Florida"	"False"
"regions_onscreen_france"	"France"	"False"
"regions_onscreen_french_guyana"	"French Guyana"	"False"
"regions_onscreen_galicia"	"Galicia & Podolia"	"False"
"regions_onscreen_galicia"	"Ukraine"	"False"
"regions_onscreen_genoa"	"Liguria"	"False"
"regions_onscreen_georgia"	"Georgia"	"False"
"regions_onscreen_georgia"	"Hevsuriya"	"False"
"regions_onscreen_georgia_usa"	"Circassia - Hevsuri"	"False"
"regions_onscreen_georgia_usa"	"Georgia"	"False"
"regions_onscreen_gibraltar"	"Gibraltar"	"False"
"regions_onscreen_great_plains"	"Black Hills"	"False"
"regions_onscreen_greece"	"Greece"	"False"
"regions_onscreen_greenland"	"Greenland"	"False"
"regions_onscreen_guatemala"	"Guatemala"	"False"
"regions_onscreen_gujarat"	"Gujarat"	"False"
"regions_onscreen_hannover"	"Hannover"	"False"
"regions_onscreen_hausa"	"Hausa"	"False"
"regions_onscreen_himalayas"	"Himalayas"	"False"
"regions_onscreen_hindukush"	"Hindukush"	"False"
"regions_onscreen_hindustan"	"Hindustan"	"False"
"regions_onscreen_hispaniola"	"Hispaniola"	"False"
"regions_onscreen_hungary"	"Hungary"	"False"
"regions_onscreen_huron_territory"	"Huron Territory"	"False"
"regions_onscreen_hyderabad"	"Hyderabad"	"False"
"regions_onscreen_iceland"	"Iceland"	"False"
"regions_onscreen_indochina"	"Indochina"	"False"
"regions_onscreen_ingria"	"Ingria"	"False"
"regions_onscreen_ireland"	"Ireland"	"False"
"regions_onscreen_iroquois_territory"	"Iroquois Territory"	"False"
"regions_onscreen_ivory_coast"	"Ivory Coast"	"False"
"regions_onscreen_jamaica"	"Jamaica"	"False"
"regions_onscreen_kaintuck_territory"	"Kaintuck Territory"	"False"
"regions_onscreen_kalahari"	"Kalahari"	"False"
"regions_onscreen_karelia"	"Karelia"	"False"
"regions_onscreen_kashmir"	"Kashmir"	"False"
"regions_onscreen_komi"	"Komi"	"False"
"regions_onscreen_labrador"	"Montagnais"	"False"
"regions_onscreen_leeward_islands"	"Leeward Islands"	"False"
"regions_onscreen_lithuania"	"Lithuania"	"False"
"regions_onscreen_lower_louisiana"	"Lower Louisiana"	"False"
"regions_onscreen_maine"	"Maine"	"False"
"regions_onscreen_malabar"	"Goa"	"False"
"regions_onscreen_malta"	"Malta"	"False"
"regions_onscreen_malwa"	"Malwa"	"False"
"regions_onscreen_maryland"	"Maryland"	"False"
"regions_onscreen_mesopotamia"	"Mesopotamia"	"False"
"regions_onscreen_michigan_territory"	"Michigan Territory"	"False"
"regions_onscreen_milan"	"Lombardy"	"False"
"regions_onscreen_moldavia"	"Moldavia"	"False"
"regions_onscreen_morea"	"Morea"	"False"
"regions_onscreen_morocco"	"Morocco"	"False"
"regions_onscreen_muscovy"	"Muscovy"	"False"
"regions_onscreen_mysore"	"Mysore"	"False"
"regions_onscreen_naples"	"Naples"	"False"
"regions_onscreen_natives_algonquin_territory"	"Algonquin Territory"	"False"
"regions_onscreen_natives_apache_territory"	"Apache Territory"	"False"
"regions_onscreen_natives_black_hills"	"Black Hills"	"False"
"regions_onscreen_natives_cheyenne_territory"	"Cheyenne Territory"	"False"
"regions_onscreen_natives_chickasaw_territory"	"Chickasaw Territory"	"False"
"regions_onscreen_natives_chihuahua"	"Chihuahua"	"False"
"regions_onscreen_natives_cree_territory"	"Cree Territory"	"False"
"regions_onscreen_natives_huron_territory"	"Huron Territory"	"False"
"regions_onscreen_natives_indiana_territory"	"Indiana Territory"	"False"
"regions_onscreen_natives_labrador"	"Labrador"	"False"
"regions_onscreen_natives_michigan_territory"	"Michigan Territory"	"False"
"regions_onscreen_natives_nw_territory"	"Northwest Territory"	"False"
"regions_onscreen_natives_ohio_territory"	"Ohio Territory"	"False"
"regions_onscreen_natives_ruperts_land"	"Rupert’s Land"	"False"
"regions_onscreen_natives_ruperts_land"	"Rupert's Land"	"False"
"regions_onscreen_natives_sioux_territory"	"Sioux Territory"	"False"
"regions_onscreen_natives_u_louisiana"	"Upper Louisiana"	"False"
"regions_onscreen_natives_wichita_territory"	"Wichita Territory"	"False"
"regions_onscreen_netherlands"	"Netherlands"	"False"
"regions_onscreen_new_andalusia"	"New Andalusia"	"False"
"regions_onscreen_new_england"	"Confederation of New England"	"False"
"regions_onscreen_new_france"	"New France"	"False"
"regions_onscreen_new_grenada"	"New Grenada"	"False"
"regions_onscreen_new_mexico"	"New Mexico"	"False"
"regions_onscreen_new_spain"	"New Spain"	"False"
"regions_onscreen_new_york"	"New York"	"False"
"regions_onscreen_newfoundland"	"Newfoundland"	"False"
"regions_onscreen_northwest_territories"	"Northwest Territories"	"False"
"regions_onscreen_northwest_territorys"	"Beaver Territory"	"False"
"regions_onscreen_norway"	"Norway"	"False"
"regions_onscreen_ontario"	"Upper Canada"	"False"
"regions_onscreen_orissa"	"Orissa & Circars"	"False"
"regions_onscreen_palestine"	"Palestine"	"False"
"regions_onscreen_panama"	"Panama"	"False"
"regions_onscreen_pennsylvania"	"Pennsylvania"	"False"
"regions_onscreen_persia"	"Persia"	"False"
"regions_onscreen_poland"	"Poland"	"False"
"regions_onscreen_portugal"	"Portugal"	"False"
"regions_onscreen_prussia"	"East Prussia"	"False"
"regions_onscreen_punjab"	"Punjab"	"False"
"regions_onscreen_rajpootana"	"Rajpootana"	"False"
"regions_onscreen_rhineland"	"Rhineland"	"False"
"regions_onscreen_rift_valley"	"Rift Valley"	"False"
"regions_onscreen_rumelia"	"Rumelia"	"False"
"regions_onscreen_ruperts_land"	"Rupert’s Land"	"False"
"regions_onscreen_ruperts_land"	"Rupert's Land"	"False"
"regions_onscreen_sahara"	"Sahara"	"False"
"regions_onscreen_sardinia"	"Sardinia"	"False"
"regions_onscreen_savoy"	"Savoy"	"False"
"regions_onscreen_saxony"	"Saxony"	"False"
"regions_onscreen_scotland"	"Scotland"	"False"
"regions_onscreen_serbia"	"Serbia"	"False"
"regions_onscreen_siberia"	"Siberia"	"False"
"regions_onscreen_silesia"	"Silesia"	"False"
"regions_onscreen_sindh"	"Sindh"	"False"
"regions_onscreen_south_africa"	"South Africa"	"False"
"regions_onscreen_spain"	"Spain"	"False"
"regions_onscreen_sweden"	"Sweden"	"False"
"regions_onscreen_syria"	"Syria"	"False"
"regions_onscreen_tatariya"	"Tatariya"	"False"
"regions_onscreen_tejas"	"Texas"	"False"
"regions_onscreen_the_papal_states"	"Central Italy"	"False"
"regions_onscreen_transylvania"	"Transylvania"	"False"
"regions_onscreen_trinidad_tobago"	"Trinidad & Tobago"	"False"
"regions_onscreen_tripoli"	"Tripolitana"	"False"
"regions_onscreen_tunis"	"Tunis"	"False"
"regions_onscreen_turkoman"	"Turkoman"	"False"
"regions_onscreen_ukraine"	"Malorossiya"	"False"
"regions_onscreen_ukraine"	"Ukraine"	"False"
"regions_onscreen_unexplorable"	"Unexplorable"	"False"
"regions_onscreen_upper_louisiana"	"Upper Louisiana"	"False"
"regions_onscreen_venice"	"Venetia"	"False"
"regions_onscreen_virginia"	"Virginia"	"False"
"regions_onscreen_west_pommerania"	"Brandenburg"	"False"
"regions_onscreen_west_prussia"	"West Prussia"	"False"
"regions_onscreen_western_plain"	"Western Plains"	"False"
"regions_onscreen_windward_islands"	"Windward Islands"	"False"
"regions_onscreen_wurttemberg"	"Wurttemberg"	"False"
"regions_sea_onscreen_name_adriatic_sea"	"Adriatic Sea"	"False"
"regions_sea_onscreen_name_arabian_sea"	"Arabian Sea"	"False"
"regions_sea_onscreen_name_arctic_ocean"	"Arctic Ocean"	"False"
"regions_sea_onscreen_name_arctic_w_ocean"	"Western Arctic Ocean"	"False"
"regions_sea_onscreen_name_atlantic_ocean_e"	"Eastern Atlantic Ocean"	"False"
"regions_sea_onscreen_name_atlantic_ocean_ne"	"Northeastern Atlantic Ocean"	"False"
"regions_sea_onscreen_name_atlantic_ocean_nw"	"Northwestern Atlantic Ocean"	"False"
"regions_sea_onscreen_name_atlantic_ocean_se"	"Southeastern Atlantic Ocean"	"False"
"regions_sea_onscreen_name_atlantic_ocean_sw"	"Southwestern Atlantic Ocean"	"False"
"regions_sea_onscreen_name_atlantic_ocean_w"	"Western Atlantic Ocean"	"False"
"regions_sea_onscreen_name_baltic_sea"	"Baltic Sea"	"False"
"regions_sea_onscreen_name_bay_of_bengal"	"Bay of Bengal"	"False"
"regions_sea_onscreen_name_bay_of_biscay"	"Bay of Biscay"	"False"
"regions_sea_onscreen_name_black_sea"	"Black Sea"	"False"
"regions_sea_onscreen_name_brazil_coast"	"Coast of Brazil"	"False"
"regions_sea_onscreen_name_caspian_sea"	"Caspian Sea"	"False"
"regions_sea_onscreen_name_doldrums"	"Doldrums"	"False"
"regions_sea_onscreen_name_east_indies"	"East Indies"	"False"
"regions_sea_onscreen_name_english_channel"	"English Channel"	"False"
"regions_sea_onscreen_name_ford_atlantic_ocean_nw"	"Northwestern Atlantic Ocean"	"False"
"regions_sea_onscreen_name_ford_atlantic_ocean_w"	"Western Atlantic Ocean"	"False"
"regions_sea_onscreen_name_ford_baltic_sea"	"Baltic Sea"	"False"
"regions_sea_onscreen_name_ford_irish_sea"	"Irish Sea"	"False"
"regions_sea_onscreen_name_ford_mediterranean_sea"	"Mediterranean Sea"	"False"
"regions_sea_onscreen_name_ford_the_caribbean_sea"	"Caribbean Sea"	"False"
"regions_sea_onscreen_name_great_lakes"	"Great Lakes"	"False"
"regions_sea_onscreen_name_greenland_sea"	"Greenland Sea"	"False"
"regions_sea_onscreen_name_gulf_of_mexico"	"Gulf of Mexico"	"False"
"regions_sea_onscreen_name_hudson_bay"	"Hudson Bay"	"False"
"regions_sea_onscreen_name_impassable"	"Impassable Sea"	"False"
"regions_sea_onscreen_name_indian_ocean"	"Indian Ocean"	"False"
"regions_sea_onscreen_name_irish_sea"	"Irish Sea"	"False"
"regions_sea_onscreen_name_ivory_coast"	"Ivory Coast"	"False"
"regions_sea_onscreen_name_mediterranean_sea"	"Mediterranean Sea"	"False"
"regions_sea_onscreen_name_north_sea"	"North Sea"	"False"
"regions_sea_onscreen_name_norwegian_sea"	"Norwegian Sea"	"False"
"regions_sea_onscreen_name_pacific_ocean"	"Pacific Ocean"	"False"
"regions_sea_onscreen_name_persian_gulf"	"Persian Gulf"	"False"
"regions_sea_onscreen_name_red_sea"	"Red Sea"	"False"
"regions_sea_onscreen_name_south_china_sea"	"South China Sea"	"False"
"regions_sea_onscreen_name_southern_ocean"	"Southern Ocean"	"False"
"regions_sea_onscreen_name_straits_of_mozambique"	"Straits of Madagascar"	"False"
"regions_sea_onscreen_name_the_caribbean_sea"	"Caribbean Sea"	"False"
"regions_sea_onscreen_name_wilderness_arabia"	"Wilderness (Arabian Desert)"	"False"
"regions_sea_onscreen_name_wilderness_canada"	"Wilderness (Labrador)"	"False"
"regions_sea_onscreen_name_wilderness_great_plains"	"Wilderness (Great Plains)"	"False"
"regions_sea_onscreen_name_wilderness_hudsonsbay"	"Wilderness (Manitoba)"	"False"
"regions_sea_onscreen_name_wilderness_khiva"	"Wilderness (Karakum Desert)"	"False"
"regions_sea_onscreen_name_wilderness_mexico"	"Wilderness (Sierra Madre)"	"False"
"regions_sea_onscreen_name_wilderness_tejas"	"Wilderness (Llano Estacado)"	"False"