"start_pos_settlements_onscreen_name_settlement:acadia:fort_nashwaak-656592089"	"Fort Nashwaak"	"False"
"start_pos_settlements_onscreen_name_settlement:acadia:fort_nashwaak127"	"Fort Nashwaak"	"False"
"start_pos_settlements_onscreen_name_settlement:acadia:fort_nashwaak213"	"Fort Nashwaak"	"False"
"start_pos_settlements_onscreen_name_settlement:acadia:fort_nashwaak472"	"Fort Nashwaak"	"False"
"start_pos_settlements_onscreen_name_settlement:acadia:louisbourg_ep3419"	"Louisbourg"	"False"
"start_pos_settlements_onscreen_name_settlement:afghanistan:kabul128"	"Kabul"	"False"
"start_pos_settlements_onscreen_name_settlement:afghanistan:kabul214"	"Kabul"	"False"
"start_pos_settlements_onscreen_name_settlement:ahmadnagar:ahmadnagar129"	"Ahmadnagar"	"False"
"start_pos_settlements_onscreen_name_settlement:ahmadnagar:ahmadnagar215"	"Ahmadnagar"	"False"
"start_pos_settlements_onscreen_name_settlement:algiers:algiers217"	"Algiers"	"False"
"start_pos_settlements_onscreen_name_settlement:algiers:algiers42"	"Algiers"	"False"
"start_pos_settlements_onscreen_name_settlement:algonquin_territory:niagara130"	"Buffalo"	"False"
"start_pos_settlements_onscreen_name_settlement:algonquin_territory:niagara130"	"Niagara"	"False"
"start_pos_settlements_onscreen_name_settlement:algonquin_territory:niagara218"	"Buffalo"	"False"
"start_pos_settlements_onscreen_name_settlement:algonquin_territory:niagara218"	"Niagara"	"False"
"start_pos_settlements_onscreen_name_settlement:algonquin_territory:niagara422"	"Buffalo"	"False"
"start_pos_settlements_onscreen_name_settlement:algonquin_territory:niagara422"	"Fort Niagara"	"False"
"start_pos_settlements_onscreen_name_settlement:algonquin_territory:niagara443"	"Buffalo"	"False"
"start_pos_settlements_onscreen_name_settlement:algonquin_territory:niagara443"	"Niagara"	"False"
"start_pos_settlements_onscreen_name_settlement:alsace:strasbourg219"	"Strasbourg"	"False"
"start_pos_settlements_onscreen_name_settlement:alsace:strasbourg43"	"Strasbourg"	"False"
"start_pos_settlements_onscreen_name_settlement:anatolia:angora220"	"Ankara"	"False"
"start_pos_settlements_onscreen_name_settlement:anatolia:angora44"	"Ankara"	"False"
"start_pos_settlements_onscreen_name_settlement:arkhangelsk:arkhangelsk221"	"Arkhangelsk"	"False"
"start_pos_settlements_onscreen_name_settlement:arkhangelsk:arkhangelsk45"	"Arkhangelsk"	"False"
"start_pos_settlements_onscreen_name_settlement:armenia:yerevan222"	"Yerevan"	"False"
"start_pos_settlements_onscreen_name_settlement:armenia:yerevan46"	"Yerevan"	"False"
"start_pos_settlements_onscreen_name_settlement:astrakhan:astrakhan223"	"Astrakhan"	"False"
"start_pos_settlements_onscreen_name_settlement:astrakhan:astrakhan47"	"Astrakhan"	"False"
"start_pos_settlements_onscreen_name_settlement:austria:vienna2"	"Vienna"	"False"
"start_pos_settlements_onscreen_name_settlement:austria:vienna224"	"Vienna"	"False"
"start_pos_settlements_onscreen_name_settlement:azerbaijan:ardabil225"	"Ardabil"	"False"
"start_pos_settlements_onscreen_name_settlement:azerbaijan:ardabil48"	"Ardabil"	"False"
"start_pos_settlements_onscreen_name_settlement:bahamas:nassau131"	"Nassau"	"False"
"start_pos_settlements_onscreen_name_settlement:bahamas:nassau226"	"Nassau"	"False"
"start_pos_settlements_onscreen_name_settlement:bahamas:nassau459"	"Nassau"	"False"
"start_pos_settlements_onscreen_name_settlement:bahamas:nassau563546076"	"Nassau"	"False"
"start_pos_settlements_onscreen_name_settlement:baluchistan:zahedan132"	"Zahedan"	"False"
"start_pos_settlements_onscreen_name_settlement:baluchistan:zahedan227"	"Zahedan"	"False"
"start_pos_settlements_onscreen_name_settlement:bashkira:ufa228"	"Ufa"	"False"
"start_pos_settlements_onscreen_name_settlement:bashkira:ufa3"	"Ufa"	"False"
"start_pos_settlements_onscreen_name_settlement:bavaria:munich229"	"Munich"	"False"
"start_pos_settlements_onscreen_name_settlement:bavaria:munich4"	"Munich"	"False"
"start_pos_settlements_onscreen_name_settlement:belarus:minsk230"	"Minsk"	"False"
"start_pos_settlements_onscreen_name_settlement:belarus:minsk50"	"Minsk"	"False"
"start_pos_settlements_onscreen_name_settlement:bengal:calcutta134"	"Calcutta"	"False"
"start_pos_settlements_onscreen_name_settlement:bengal:calcutta232"	"Calcutta"	"False"
"start_pos_settlements_onscreen_name_settlement:berar:nagpur135"	"Nagpur"	"False"
"start_pos_settlements_onscreen_name_settlement:berar:nagpur233"	"Nagpur"	"False"
"start_pos_settlements_onscreen_name_settlement:bijapur:satara136"	"Satara"	"False"
"start_pos_settlements_onscreen_name_settlement:bijapur:satara234"	"Satara"	"False"
"start_pos_settlements_onscreen_name_settlement:bohemia:prague235"	"Prague"	"False"
"start_pos_settlements_onscreen_name_settlement:bohemia:prague5"	"Prague"	"False"
"start_pos_settlements_onscreen_name_settlement:bosnia:sarajevo236"	"Sarajevo"	"False"
"start_pos_settlements_onscreen_name_settlement:bosnia:sarajevo52"	"Sarajevo"	"False"
"start_pos_settlements_onscreen_name_settlement:bulgaria:sofia239"	"Sofia"	"False"
"start_pos_settlements_onscreen_name_settlement:bulgaria:sofia54"	"Sofia"	"False"
"start_pos_settlements_onscreen_name_settlement:carnatica:arcot139"	"Arcot"	"False"
"start_pos_settlements_onscreen_name_settlement:carnatica:arcot241"	"Arcot"	"False"
"start_pos_settlements_onscreen_name_settlement:carolinas:charleston1134299565"	"Charleston"	"False"
"start_pos_settlements_onscreen_name_settlement:carolinas:charleston201"	"Charleston"	"False"
"start_pos_settlements_onscreen_name_settlement:carolinas:charleston367"	"Charleston"	"False"
"start_pos_settlements_onscreen_name_settlement:carolinas:charleston427"	"Charleston"	"False"
"start_pos_settlements_onscreen_name_settlement:ceylon:trincomalee140"	"Trincomalee"	"False"
"start_pos_settlements_onscreen_name_settlement:ceylon:trincomalee242"	"Trincomalee"	"False"
"start_pos_settlements_onscreen_name_settlement:chechenya-dagestan:tarki244"	"Tarki"	"False"
"start_pos_settlements_onscreen_name_settlement:chechenya-dagestan:tarki55"	"Tarki"	"False"
"start_pos_settlements_onscreen_name_settlement:cherokee_territory:tellico-580968086"	"Chicasa"	"False"
"start_pos_settlements_onscreen_name_settlement:cherokee_territory:tellico145"	"Chicasa"	"False"
"start_pos_settlements_onscreen_name_settlement:cherokee_territory:tellico145"	"Nashville"	"False"
"start_pos_settlements_onscreen_name_settlement:cherokee_territory:tellico251"	"Chicasa"	"False"
"start_pos_settlements_onscreen_name_settlement:cherokee_territory:tellico251"	"Nashville"	"False"
"start_pos_settlements_onscreen_name_settlement:cherokee_territory:tellico440"	"Chicasa"	"False"
"start_pos_settlements_onscreen_name_settlement:cherokee_territory:tellico440"	"Nashville"	"False"
"start_pos_settlements_onscreen_name_settlement:corsica:bastia249"	"Bastia"	"False"
"start_pos_settlements_onscreen_name_settlement:corsica:bastia56"	"Bastia"	"False"
"start_pos_settlements_onscreen_name_settlement:courland:jelgava250"	"Jelgava"	"False"
"start_pos_settlements_onscreen_name_settlement:courland:jelgava57"	"Jelgava"	"False"
"start_pos_settlements_onscreen_name_settlement:crimea:bakhchisaray253"	"Bakhchisaray"	"False"
"start_pos_settlements_onscreen_name_settlement:crimea:bakhchisaray60"	"Bakhchisaray"	"False"
"start_pos_settlements_onscreen_name_settlement:croatia:zagreb254"	"Zagreb"	"False"
"start_pos_settlements_onscreen_name_settlement:croatia:zagreb61"	"Zagreb"	"False"
"start_pos_settlements_onscreen_name_settlement:cuba:la_habana146"	"La Habana"	"False"
"start_pos_settlements_onscreen_name_settlement:cuba:la_habana255"	"La Habana"	"False"
"start_pos_settlements_onscreen_name_settlement:cuba:la_habana446"	"La Habana"	"False"
"start_pos_settlements_onscreen_name_settlement:cuba:la_habana708713379"	"La Habana"	"False"
"start_pos_settlements_onscreen_name_settlement:curacao:punda147"	"Punda"	"False"
"start_pos_settlements_onscreen_name_settlement:curacao:punda1667773673"	"Punda"	"False"
"start_pos_settlements_onscreen_name_settlement:curacao:punda256"	"Punda"	"False"
"start_pos_settlements_onscreen_name_settlement:curacao:punda863980968"	"Punda"	"False"
"start_pos_settlements_onscreen_name_settlement:denmark:copenhagen261"	"Copenhagen"	"False"
"start_pos_settlements_onscreen_name_settlement:denmark:copenhagen6"	"Copenhagen"	"False"
"start_pos_settlements_onscreen_name_settlement:don_voisko:cherkassk262"	"Cherkassk"	"False"
"start_pos_settlements_onscreen_name_settlement:don_voisko:cherkassk64"	"Cherkassk"	"False"
"start_pos_settlements_onscreen_name_settlement:dutch_guyana:paramaribo-1582519549"	"Paramaribo"	"False"
"start_pos_settlements_onscreen_name_settlement:dutch_guyana:paramaribo-1893362039"	"Paramaribo"	"False"
"start_pos_settlements_onscreen_name_settlement:dutch_guyana:paramaribo202"	"Paramaribo"	"False"
"start_pos_settlements_onscreen_name_settlement:dutch_guyana:paramaribo369"	"Paramaribo"	"False"
"start_pos_settlements_onscreen_name_settlement:egypt:cairo263"	"Cairo"	"False"
"start_pos_settlements_onscreen_name_settlement:egypt:cairo65"	"Cairo"	"False"
"start_pos_settlements_onscreen_name_settlement:england:london265"	"London"	"False"
"start_pos_settlements_onscreen_name_settlement:england:london8"	"London"	"False"
"start_pos_settlements_onscreen_name_settlement:estonia_and_livonia:riga266"	"Riga"	"False"
"start_pos_settlements_onscreen_name_settlement:estonia_and_livonia:riga67"	"Riga"	"False"
"start_pos_settlements_onscreen_name_settlement:finland:aabo11"	"Åbo"	"False"
"start_pos_settlements_onscreen_name_settlement:finland:aabo267"	"Åbo"	"False"
"start_pos_settlements_onscreen_name_settlement:flanders:brussels268"	"Brussels"	"False"
"start_pos_settlements_onscreen_name_settlement:flanders:brussels68"	"Brussels"	"False"
"start_pos_settlements_onscreen_name_settlement:florida:st_augustine-1541764074"	"St. Augustine"	"False"
"start_pos_settlements_onscreen_name_settlement:florida:st_augustine149"	"St. Augustine"	"False"
"start_pos_settlements_onscreen_name_settlement:florida:st_augustine269"	"St. Augustine"	"False"
"start_pos_settlements_onscreen_name_settlement:florida:st_augustine463"	"St. Augustine"	"False"
"start_pos_settlements_onscreen_name_settlement:france:paris10"	"Paris"	"False"
"start_pos_settlements_onscreen_name_settlement:france:paris270"	"Paris"	"False"
"start_pos_settlements_onscreen_name_settlement:french_guyana:cayenne-905550881"	"Cayenne"	"False"
"start_pos_settlements_onscreen_name_settlement:french_guyana:cayenne150"	"Cayenne"	"False"
"start_pos_settlements_onscreen_name_settlement:french_guyana:cayenne1901361749"	"Cayenne"	"False"
"start_pos_settlements_onscreen_name_settlement:french_guyana:cayenne271"	"Cayenne"	"False"
"start_pos_settlements_onscreen_name_settlement:galicia:lwow272"	"Lwów"	"False"
"start_pos_settlements_onscreen_name_settlement:galicia:lwow69"	"Lwów"	"False"
"start_pos_settlements_onscreen_name_settlement:genoa:genoa273"	"Genoa"	"False"
"start_pos_settlements_onscreen_name_settlement:genoa:genoa70"	"Genoa"	"False"
"start_pos_settlements_onscreen_name_settlement:georgia:tbilisi274"	"Tbilisi"	"False"
"start_pos_settlements_onscreen_name_settlement:georgia:tbilisi71"	"Tbilisi"	"False"
"start_pos_settlements_onscreen_name_settlement:georgia_usa:savannah151"	"Savannah"	"False"
"start_pos_settlements_onscreen_name_settlement:georgia_usa:savannah275"	"Savannah"	"False"
"start_pos_settlements_onscreen_name_settlement:georgia_usa:savannah426"	"Savannah"	"False"
"start_pos_settlements_onscreen_name_settlement:georgia_usa:savannah496625716"	"Savannah"	"False"
"start_pos_settlements_onscreen_name_settlement:gibraltar:gibraltar276"	"Gibraltar"	"False"
"start_pos_settlements_onscreen_name_settlement:gibraltar:gibraltar72"	"Gibraltar"	"False"
"start_pos_settlements_onscreen_name_settlement:great_plains:knife_river_village166"	"Yankton"	"False"
"start_pos_settlements_onscreen_name_settlement:great_plains:knife_river_village303"	"Yankton"	"False"
"start_pos_settlements_onscreen_name_settlement:great_plains:knife_river_village455"	"Yankton"	"False"
"start_pos_settlements_onscreen_name_settlement:greece:athens277"	"Athens"	"False"
"start_pos_settlements_onscreen_name_settlement:greece:athens73"	"Athens"	"False"
"start_pos_settlements_onscreen_name_settlement:guatemala:antigua_guatemala-2085844699"	"Antigua Guatemala"	"False"
"start_pos_settlements_onscreen_name_settlement:guatemala:antigua_guatemala153"	"Antigua Guatemala"	"False"
"start_pos_settlements_onscreen_name_settlement:guatemala:antigua_guatemala278"	"Antigua Guatemala"	"False"
"start_pos_settlements_onscreen_name_settlement:guatemala:antigua_guatemala447"	"Antigua Guatemala"	"False"
"start_pos_settlements_onscreen_name_settlement:gujarat:ahmedabad154"	"Ahmedabad"	"False"
"start_pos_settlements_onscreen_name_settlement:gujarat:ahmedabad280"	"Ahmedabad"	"False"
"start_pos_settlements_onscreen_name_settlement:hannover:hannover282"	"Hannover"	"False"
"start_pos_settlements_onscreen_name_settlement:hannover:hannover75"	"Hannover"	"False"
"start_pos_settlements_onscreen_name_settlement:hindustan:agra155"	"Akbarabad"	"False"
"start_pos_settlements_onscreen_name_settlement:hindustan:agra284"	"Akbarabad"	"False"
"start_pos_settlements_onscreen_name_settlement:hispaniola:santo_domingo156"	"Santo Domingo"	"False"
"start_pos_settlements_onscreen_name_settlement:hispaniola:santo_domingo2026592642"	"Santo Domingo"	"False"
"start_pos_settlements_onscreen_name_settlement:hispaniola:santo_domingo285"	"Santo Domingo"	"False"
"start_pos_settlements_onscreen_name_settlement:hispaniola:santo_domingo445"	"Santo Domingo"	"False"
"start_pos_settlements_onscreen_name_settlement:hungary:pressburg286"	"Preßburg"	"False"
"start_pos_settlements_onscreen_name_settlement:hungary:pressburg77"	"Preßburg"	"False"
"start_pos_settlements_onscreen_name_settlement:huron_territory:fort_sault_ste-marie157"	"Fort Sault Ste. Marie"	"False"
"start_pos_settlements_onscreen_name_settlement:huron_territory:fort_sault_ste-marie287"	"Fort Sault Ste. Marie"	"False"
"start_pos_settlements_onscreen_name_settlement:huron_territory:fort_sault_ste-marie420"	"Fort Sault Ste. Marie"	"False"
"start_pos_settlements_onscreen_name_settlement:huron_territory:fort_sault_ste-marie469"	"Fort Sault Ste. Marie"	"False"
"start_pos_settlements_onscreen_name_settlement:hyderabad:hyderabad158"	"Hyderabad"	"False"
"start_pos_settlements_onscreen_name_settlement:hyderabad:hyderabad288"	"Hyderabad"	"False"
"start_pos_settlements_onscreen_name_settlement:iceland:reykjavik289"	"Reykjavík"	"False"
"start_pos_settlements_onscreen_name_settlement:iceland:reykjavik7"	"Reykjavík"	"False"
"start_pos_settlements_onscreen_name_settlement:ingria:st_petersburg290"	"St. Petersburg"	"False"
"start_pos_settlements_onscreen_name_settlement:ingria:st_petersburg78"	"St. Petersburg"	"False"
"start_pos_settlements_onscreen_name_settlement:ireland:dublin291"	"Dublin"	"False"
"start_pos_settlements_onscreen_name_settlement:ireland:dublin79"	"Dublin"	"False"
"start_pos_settlements_onscreen_name_settlement:iroquois_territory:cayuga159"	"Cayuga"	"False"
"start_pos_settlements_onscreen_name_settlement:iroquois_territory:cayuga159"	"Rochester"	"False"
"start_pos_settlements_onscreen_name_settlement:iroquois_territory:cayuga292"	"Cayuga"	"False"
"start_pos_settlements_onscreen_name_settlement:iroquois_territory:cayuga292"	"Rochester"	"False"
"start_pos_settlements_onscreen_name_settlement:iroquois_territory:cayuga421"	"Fort Carillon"	"False"
"start_pos_settlements_onscreen_name_settlement:iroquois_territory:cayuga421"	"Rochester"	"False"
"start_pos_settlements_onscreen_name_settlement:iroquois_territory:cayuga442"	"Cayuga"	"False"
"start_pos_settlements_onscreen_name_settlement:iroquois_territory:cayuga442"	"Rochester"	"False"
"start_pos_settlements_onscreen_name_settlement:iroquois_territory:cayuga_natives1151961051"	"Cayuga"	"False"
"start_pos_settlements_onscreen_name_settlement:jamaica:port_royal1369154432"	"Port Royal"	"False"
"start_pos_settlements_onscreen_name_settlement:jamaica:port_royal160"	"Port Royal"	"False"
"start_pos_settlements_onscreen_name_settlement:jamaica:port_royal293"	"Port Royal"	"False"
"start_pos_settlements_onscreen_name_settlement:jamaica:port_royal458"	"Port Royal"	"False"
"start_pos_settlements_onscreen_name_settlement:kaintuck_territory:tanase-1925137023"	"Tellico"	"False"
"start_pos_settlements_onscreen_name_settlement:kaintuck_territory:tanase161"	"Tellico"	"False"
"start_pos_settlements_onscreen_name_settlement:kaintuck_territory:tanase294"	"Tellico"	"False"
"start_pos_settlements_onscreen_name_settlement:kaintuck_territory:tanase441"	"Tellico"	"False"
"start_pos_settlements_onscreen_name_settlement:karelia:petrovskaya_sloboda12"	"Petrovskaya Sloboda"	"False"
"start_pos_settlements_onscreen_name_settlement:karelia:petrovskaya_sloboda296"	"Petrovskaya Sloboda"	"False"
"start_pos_settlements_onscreen_name_settlement:kashmir:srinagar162"	"Srinagar"	"False"
"start_pos_settlements_onscreen_name_settlement:kashmir:srinagar297"	"Srinagar"	"False"
"start_pos_settlements_onscreen_name_settlement:komi:ust_sysolsk13"	"Ust-Sysolsk"	"False"
"start_pos_settlements_onscreen_name_settlement:komi:ust_sysolsk300"	"Ust-Sysolsk"	"False"
"start_pos_settlements_onscreen_name_settlement:labrador:agvituk-536476225"	"Agvituk"	"False"
"start_pos_settlements_onscreen_name_settlement:labrador:agvituk164"	"Agvituk"	"False"
"start_pos_settlements_onscreen_name_settlement:labrador:agvituk301"	"Agvituk"	"False"
"start_pos_settlements_onscreen_name_settlement:labrador:agvituk476"	"Agvituk"	"False"
"start_pos_settlements_onscreen_name_settlement:leeward_islands:antigua-1713162834"	"Antigua"	"False"
"start_pos_settlements_onscreen_name_settlement:leeward_islands:antigua167"	"Antigua"	"False"
"start_pos_settlements_onscreen_name_settlement:leeward_islands:antigua304"	"Antigua"	"False"
"start_pos_settlements_onscreen_name_settlement:leeward_islands:antigua457"	"Antigua"	"False"
"start_pos_settlements_onscreen_name_settlement:lithuania:vilnius305"	"Vilnius"	"False"
"start_pos_settlements_onscreen_name_settlement:lithuania:vilnius80"	"Vilnius"	"False"
"start_pos_settlements_onscreen_name_settlement:lower_louisiana:new_orleans-1263877225"	"New Orleans"	"False"
"start_pos_settlements_onscreen_name_settlement:lower_louisiana:new_orleans168"	"New Orleans"	"False"
"start_pos_settlements_onscreen_name_settlement:lower_louisiana:new_orleans307"	"New Orleans"	"False"
"start_pos_settlements_onscreen_name_settlement:lower_louisiana:new_orleans462"	"New Orleans"	"False"
"start_pos_settlements_onscreen_name_settlement:maine:falmouth1618873228"	"Falmouth"	"False"
"start_pos_settlements_onscreen_name_settlement:maine:falmouth169"	"Falmouth"	"False"
"start_pos_settlements_onscreen_name_settlement:maine:falmouth308"	"Falmouth"	"False"
"start_pos_settlements_onscreen_name_settlement:maine:falmouth407"	"Falmouth"	"False"
"start_pos_settlements_onscreen_name_settlement:maine:falmouth438"	"Falmouth"	"False"
"start_pos_settlements_onscreen_name_settlement:malabar:goa170"	"Goa"	"False"
"start_pos_settlements_onscreen_name_settlement:malabar:goa309"	"Goa"	"False"
"start_pos_settlements_onscreen_name_settlement:malta:valletta310"	"Valletta"	"False"
"start_pos_settlements_onscreen_name_settlement:malta:valletta81"	"Valletta"	"False"
"start_pos_settlements_onscreen_name_settlement:malwa:ujjain171"	"Ujjain"	"False"
"start_pos_settlements_onscreen_name_settlement:malwa:ujjain311"	"Ujjain"	"False"
"start_pos_settlements_onscreen_name_settlement:maryland:annapolis1535627165"	"Annapolis"	"False"
"start_pos_settlements_onscreen_name_settlement:maryland:annapolis173"	"Annapolis"	"False"
"start_pos_settlements_onscreen_name_settlement:maryland:annapolis173"	"Washington D.C."	"False"
"start_pos_settlements_onscreen_name_settlement:maryland:annapolis313"	"Annapolis"	"False"
"start_pos_settlements_onscreen_name_settlement:maryland:annapolis313"	"Washington D.C."	"False"
"start_pos_settlements_onscreen_name_settlement:maryland:annapolis329363402"	"Washington D.C."	"False"
"start_pos_settlements_onscreen_name_settlement:maryland:annapolis329363402"	"Werowocomoco"	"False"
"start_pos_settlements_onscreen_name_settlement:maryland:annapolis414"	"Paxtang"	"False"
"start_pos_settlements_onscreen_name_settlement:maryland:annapolis414"	"Washington D.C."	"False"
"start_pos_settlements_onscreen_name_settlement:maryland:annapolis430"	"Annapolis"	"False"
"start_pos_settlements_onscreen_name_settlement:maryland:annapolis430"	"Washington D.C."	"False"
"start_pos_settlements_onscreen_name_settlement:mesopotamia:baghdad317"	"Baghdad"	"False"
"start_pos_settlements_onscreen_name_settlement:mesopotamia:baghdad83"	"Baghdad"	"False"
"start_pos_settlements_onscreen_name_settlement:michigan_territory:detroit175"	"Detroit"	"False"
"start_pos_settlements_onscreen_name_settlement:michigan_territory:detroit175"	"Fort Pontchartrain du Detroit"	"False"
"start_pos_settlements_onscreen_name_settlement:michigan_territory:detroit319"	"Detroit"	"False"
"start_pos_settlements_onscreen_name_settlement:michigan_territory:detroit319"	"Fort Pontchartrain du Detroit"	"False"
"start_pos_settlements_onscreen_name_settlement:michigan_territory:detroit423"	"Detroit"	"False"
"start_pos_settlements_onscreen_name_settlement:michigan_territory:detroit423"	"Fort Pontchartrain du Detroit"	"False"
"start_pos_settlements_onscreen_name_settlement:michigan_territory:detroit464"	"Detroit"	"False"
"start_pos_settlements_onscreen_name_settlement:michigan_territory:detroit464"	"Fort Pontchartrain du Detroit"	"False"
"start_pos_settlements_onscreen_name_settlement:milan:milano14"	"Milan"	"False"
"start_pos_settlements_onscreen_name_settlement:milan:milano320"	"Milan"	"False"
"start_pos_settlements_onscreen_name_settlement:moldavia:iasi323"	"Iasi"	"False"
"start_pos_settlements_onscreen_name_settlement:moldavia:iasi84"	"Iasi"	"False"
"start_pos_settlements_onscreen_name_settlement:morea:patras324"	"Patras"	"False"
"start_pos_settlements_onscreen_name_settlement:morea:patras85"	"Patras"	"False"
"start_pos_settlements_onscreen_name_settlement:morocco:tangier325"	"Tangier"	"False"
"start_pos_settlements_onscreen_name_settlement:morocco:tangier86"	"Tangier"	"False"
"start_pos_settlements_onscreen_name_settlement:muscovy:moscow15"	"Moscow"	"False"
"start_pos_settlements_onscreen_name_settlement:muscovy:moscow327"	"Moscow"	"False"
"start_pos_settlements_onscreen_name_settlement:mysore:mysore179"	"Mysore"	"False"
"start_pos_settlements_onscreen_name_settlement:mysore:mysore328"	"Mysore"	"False"
"start_pos_settlements_onscreen_name_settlement:naples:naples329"	"Naples"	"False"
"start_pos_settlements_onscreen_name_settlement:naples:naples87"	"Naples"	"False"
"start_pos_settlements_onscreen_name_settlement:natives_algonquin_territory:niagara-1314485094"	"Niagara"	"False"
"start_pos_settlements_onscreen_name_settlement:natives_apache_territory:quivira-2129063149"	"Quivira"	"False"
"start_pos_settlements_onscreen_name_settlement:natives_black_hills:knife_river_village-565482408"	"Yankton"	"False"
"start_pos_settlements_onscreen_name_settlement:natives_cheyenne_territory:cheyenne882449273"	"Cheyenne"	"False"
"start_pos_settlements_onscreen_name_settlement:natives_chickasaw_territory:autiamique249072198"	"Autiamique"	"False"
"start_pos_settlements_onscreen_name_settlement:natives_chihuahua:chihuahua-607440305"	"Chihuahua"	"False"
"start_pos_settlements_onscreen_name_settlement:natives_huron_territory:ft_st_marie2058015204"	"Fort Sault Ste. Marie"	"False"
"start_pos_settlements_onscreen_name_settlement:natives_indiana_territory:shikaawa228179221"	"Shikaawa"	"False"
"start_pos_settlements_onscreen_name_settlement:natives_labrador:agvituk539433650"	"Agvituk"	"False"
"start_pos_settlements_onscreen_name_settlement:natives_michigan_territory:detroit2069601611"	"Fort Pontchartrain du Detroit"	"False"
"start_pos_settlements_onscreen_name_settlement:natives_nw_territory:york_factory439093296"	"York Factory"	"False"
"start_pos_settlements_onscreen_name_settlement:natives_ohio_territory:fallen_timbers1159237745"	"Fallen Timbers"	"False"
"start_pos_settlements_onscreen_name_settlement:natives_ruperts_land:moose_factory-564729378"	"Moose Factory"	"False"
"start_pos_settlements_onscreen_name_settlement:natives_sioux_territory:sioux_falls-857436153"	"Sioux Falls"	"False"
"start_pos_settlements_onscreen_name_settlement:natives_u_louisiana:fort_chartres2085854012"	"Fort de Chartres"	"False"
"start_pos_settlements_onscreen_name_settlement:natives_wichita_territory:wichita_falls-1691733619"	"Wichita Falls"	"False"
"start_pos_settlements_onscreen_name_settlement:netherlands:amsterdam330"	"Amsterdam"	"False"
"start_pos_settlements_onscreen_name_settlement:netherlands:amsterdam88"	"Amsterdam"	"False"
"start_pos_settlements_onscreen_name_settlement:new_andalusia:caracas-1925963088"	"Caracas"	"False"
"start_pos_settlements_onscreen_name_settlement:new_andalusia:caracas180"	"Caracas"	"False"
"start_pos_settlements_onscreen_name_settlement:new_andalusia:caracas331"	"Caracas"	"False"
"start_pos_settlements_onscreen_name_settlement:new_andalusia:caracas_natives-1859165238"	"Caracas"	"False"
"start_pos_settlements_onscreen_name_settlement:new_england:boston174"	"Boston"	"False"
"start_pos_settlements_onscreen_name_settlement:new_england:boston314"	"Boston"	"False"
"start_pos_settlements_onscreen_name_settlement:new_england:boston435"	"Boston"	"False"
"start_pos_settlements_onscreen_name_settlement:new_england:boston_ep2410"	"Boston"	"False"
"start_pos_settlements_onscreen_name_settlement:new_england:boston_natives-1719925117"	"Boston"	"False"
"start_pos_settlements_onscreen_name_settlement:new_france:quebec181"	"Québec"	"False"
"start_pos_settlements_onscreen_name_settlement:new_france:quebec332"	"Québec"	"False"
"start_pos_settlements_onscreen_name_settlement:new_france:quebec471"	"Québec"	"False"
"start_pos_settlements_onscreen_name_settlement:new_france:quebec_ep2417"	"Québec"	"False"
"start_pos_settlements_onscreen_name_settlement:new_france:quebec_natives-1167665400"	"Québec"	"False"
"start_pos_settlements_onscreen_name_settlement:new_grenada:bogota-1018889111"	"Bogotá"	"False"
"start_pos_settlements_onscreen_name_settlement:new_grenada:bogota1236422962"	"Bogotá"	"False"
"start_pos_settlements_onscreen_name_settlement:new_grenada:bogota182"	"Bogotá"	"False"
"start_pos_settlements_onscreen_name_settlement:new_grenada:bogota333"	"Bogotá"	"False"
"start_pos_settlements_onscreen_name_settlement:new_mexico:santa_fe185"	"Santa Fe"	"False"
"start_pos_settlements_onscreen_name_settlement:new_mexico:santa_fe336"	"Santa Fe"	"False"
"start_pos_settlements_onscreen_name_settlement:new_mexico:santa_fe451"	"Santa Fe"	"False"
"start_pos_settlements_onscreen_name_settlement:new_mexico:santa_fe455521398"	"Santa Fe"	"False"
"start_pos_settlements_onscreen_name_settlement:new_spain:mexico186"	"México"	"False"
"start_pos_settlements_onscreen_name_settlement:new_spain:mexico337"	"México"	"False"
"start_pos_settlements_onscreen_name_settlement:new_spain:mexico449"	"México"	"False"
"start_pos_settlements_onscreen_name_settlement:new_spain:mexico_natives-613434177"	"México"	"False"
"start_pos_settlements_onscreen_name_settlement:new_york:albany-1426602092"	"Albany"	"False"
"start_pos_settlements_onscreen_name_settlement:new_york:albany187"	"Albany"	"False"
"start_pos_settlements_onscreen_name_settlement:new_york:albany338"	"Albany"	"False"
"start_pos_settlements_onscreen_name_settlement:new_york:albany409"	"Albany"	"False"
"start_pos_settlements_onscreen_name_settlement:new_york:albany436"	"Albany"	"False"
"start_pos_settlements_onscreen_name_settlement:newfoundland:plaissance-1411576571"	"Plaissance"	"False"
"start_pos_settlements_onscreen_name_settlement:newfoundland:plaissance1195568661"	"Plaissance"	"False"
"start_pos_settlements_onscreen_name_settlement:newfoundland:plaissance188"	"Plaissance"	"False"
"start_pos_settlements_onscreen_name_settlement:newfoundland:plaissance339"	"Plaissance"	"False"
"start_pos_settlements_onscreen_name_settlement:newfoundland:plaissance477"	"Plaissance"	"False"
"start_pos_settlements_onscreen_name_settlement:northwest_territories:york_factory172"	"York Factory"	"False"
"start_pos_settlements_onscreen_name_settlement:northwest_territories:york_factory312"	"York Factory"	"False"
"start_pos_settlements_onscreen_name_settlement:northwest_territories:york_factory468"	"York Factory"	"False"
"start_pos_settlements_onscreen_name_settlement:norway:christiania341"	"Christiania"	"False"
"start_pos_settlements_onscreen_name_settlement:norway:christiania89"	"Christiania"	"False"
"start_pos_settlements_onscreen_name_settlement:ontario:montreal-1211250718"	"Montréal"	"False"
"start_pos_settlements_onscreen_name_settlement:ontario:montreal191"	"Montréal"	"False"
"start_pos_settlements_onscreen_name_settlement:ontario:montreal343"	"Montréal"	"False"
"start_pos_settlements_onscreen_name_settlement:ontario:montreal418"	"Montréal"	"False"
"start_pos_settlements_onscreen_name_settlement:ontario:montreal470"	"Montréal"	"False"
"start_pos_settlements_onscreen_name_settlement:orissa:cuttack192"	"Cuttack"	"False"
"start_pos_settlements_onscreen_name_settlement:orissa:cuttack344"	"Cuttack"	"False"
"start_pos_settlements_onscreen_name_settlement:palestine:jerusalem346"	"Jerusalem"	"False"
"start_pos_settlements_onscreen_name_settlement:palestine:jerusalem91"	"Jerusalem"	"False"
"start_pos_settlements_onscreen_name_settlement:panama:panama1061236411"	"Panama"	"False"
"start_pos_settlements_onscreen_name_settlement:panama:panama1203422308"	"Panama"	"False"
"start_pos_settlements_onscreen_name_settlement:panama:panama194"	"Panama"	"False"
"start_pos_settlements_onscreen_name_settlement:panama:panama347"	"Panama"	"False"
"start_pos_settlements_onscreen_name_settlement:pennsylvania:ep_1_philadelphia1214404757"	"Philadelphia"	"False"
"start_pos_settlements_onscreen_name_settlement:pennsylvania:ep_1_philadelphia1214404757"	"Shackamaxon"	"False"
"start_pos_settlements_onscreen_name_settlement:pennsylvania:philadelphia195"	"Philadelphia"	"False"
"start_pos_settlements_onscreen_name_settlement:pennsylvania:philadelphia348"	"Philadelphia"	"False"
"start_pos_settlements_onscreen_name_settlement:pennsylvania:philadelphia412"	"Philadelphia"	"False"
"start_pos_settlements_onscreen_name_settlement:pennsylvania:philadelphia412"	"Shamokin"	"False"
"start_pos_settlements_onscreen_name_settlement:pennsylvania:philadelphia432"	"Philadelphia"	"False"
"start_pos_settlements_onscreen_name_settlement:pennsylvania:philadelphia_natives-164546336"	"Philadelphia"	"False"
"start_pos_settlements_onscreen_name_settlement:persia:isfahan349"	"Esfahan"	"False"
"start_pos_settlements_onscreen_name_settlement:persia:isfahan92"	"Esfahan"	"False"
"start_pos_settlements_onscreen_name_settlement:poland:warsaw351"	"Warsaw"	"False"
"start_pos_settlements_onscreen_name_settlement:poland:warsaw94"	"Warsaw"	"False"
"start_pos_settlements_onscreen_name_settlement:portugal:lisbon352"	"Lisbon"	"False"
"start_pos_settlements_onscreen_name_settlement:portugal:lisbon95"	"Lisbon"	"False"
"start_pos_settlements_onscreen_name_settlement:prussia:konigsberg353"	"Königsberg"	"False"
"start_pos_settlements_onscreen_name_settlement:prussia:konigsberg96"	"Königsberg"	"False"
"start_pos_settlements_onscreen_name_settlement:punjab:lahore165"	"Lahore"	"False"
"start_pos_settlements_onscreen_name_settlement:punjab:lahore302"	"Lahore"	"False"
"start_pos_settlements_onscreen_name_settlement:rajpootana:udaipur197"	"Udaipur"	"False"
"start_pos_settlements_onscreen_name_settlement:rajpootana:udaipur355"	"Udaipur"	"False"
"start_pos_settlements_onscreen_name_settlement:rhineland:koln114"	"Cologne"	"False"
"start_pos_settlements_onscreen_name_settlement:rhineland:koln390"	"Cologne"	"False"
"start_pos_settlements_onscreen_name_settlement:rumelia:constantinople356"	"Istanbul"	"False"
"start_pos_settlements_onscreen_name_settlement:rumelia:constantinople97"	"Istanbul"	"False"
"start_pos_settlements_onscreen_name_settlement:ruperts_land:moose_factory198"	"Moose Factory"	"False"
"start_pos_settlements_onscreen_name_settlement:ruperts_land:moose_factory357"	"Moose Factory"	"False"
"start_pos_settlements_onscreen_name_settlement:ruperts_land:moose_factory474"	"Moose Factory"	"False"
"start_pos_settlements_onscreen_name_settlement:sardinia:caligari358"	"Cagliari"	"False"
"start_pos_settlements_onscreen_name_settlement:sardinia:caligari98"	"Cagliari"	"False"
"start_pos_settlements_onscreen_name_settlement:savoy:turin17"	"Turin"	"False"
"start_pos_settlements_onscreen_name_settlement:savoy:turin359"	"Turin"	"False"
"start_pos_settlements_onscreen_name_settlement:saxony:dresden18"	"Dresden"	"False"
"start_pos_settlements_onscreen_name_settlement:saxony:dresden360"	"Dresden"	"False"
"start_pos_settlements_onscreen_name_settlement:scotland:edinburgh20"	"Edinburgh"	"False"
"start_pos_settlements_onscreen_name_settlement:scotland:edinburgh362"	"Edinburgh"	"False"
"start_pos_settlements_onscreen_name_settlement:serbia:belgrade363"	"Belgrade"	"False"
"start_pos_settlements_onscreen_name_settlement:serbia:belgrade99"	"Belgrade"	"False"
"start_pos_settlements_onscreen_name_settlement:silesia:breslau101"	"Breslau"	"False"
"start_pos_settlements_onscreen_name_settlement:silesia:breslau365"	"Breslau"	"False"
"start_pos_settlements_onscreen_name_settlement:sindh:neroon_kot200"	"Neroon Kot"	"False"
"start_pos_settlements_onscreen_name_settlement:sindh:neroon_kot366"	"Neroon Kot"	"False"
"start_pos_settlements_onscreen_name_settlement:spain:madrid102"	"Madrid"	"False"
"start_pos_settlements_onscreen_name_settlement:spain:madrid368"	"Madrid"	"False"
"start_pos_settlements_onscreen_name_settlement:sweden:stockholm103"	"Stockholm"	"False"
"start_pos_settlements_onscreen_name_settlement:sweden:stockholm370"	"Stockholm"	"False"
"start_pos_settlements_onscreen_name_settlement:syria:damascus104"	"Damascus"	"False"
"start_pos_settlements_onscreen_name_settlement:syria:damascus372"	"Damascus"	"False"
"start_pos_settlements_onscreen_name_settlement:tatariya:kazan121"	"Kazan"	"False"
"start_pos_settlements_onscreen_name_settlement:tatariya:kazan373"	"Kazan"	"False"
"start_pos_settlements_onscreen_name_settlement:tejas:villa_de_bexar1472216929"	"Villa de Bexar"	"False"
"start_pos_settlements_onscreen_name_settlement:tejas:villa_de_bexar203"	"Austin"	"False"
"start_pos_settlements_onscreen_name_settlement:tejas:villa_de_bexar203"	"Villa de Bexar"	"False"
"start_pos_settlements_onscreen_name_settlement:tejas:villa_de_bexar374"	"Austin"	"False"
"start_pos_settlements_onscreen_name_settlement:tejas:villa_de_bexar374"	"Villa de Bexar"	"False"
"start_pos_settlements_onscreen_name_settlement:tejas:villa_de_bexar450"	"Austin"	"False"
"start_pos_settlements_onscreen_name_settlement:tejas:villa_de_bexar450"	"Villa de Bexar"	"False"
"start_pos_settlements_onscreen_name_settlement:the_papal_states:rome105"	"Rome"	"False"
"start_pos_settlements_onscreen_name_settlement:the_papal_states:rome375"	"Rome"	"False"
"start_pos_settlements_onscreen_name_settlement:transylvania:kolozsvar107"	"Klausenburg"	"False"
"start_pos_settlements_onscreen_name_settlement:transylvania:kolozsvar376"	"Klausenburg"	"False"
"start_pos_settlements_onscreen_name_settlement:trinidad_tobago:san_jose_de_oruna-654554610"	"San José de Oruña"	"False"
"start_pos_settlements_onscreen_name_settlement:trinidad_tobago:san_jose_de_oruna205"	"San José de Oruña"	"False"
"start_pos_settlements_onscreen_name_settlement:trinidad_tobago:san_jose_de_oruna378"	"San José de Oruña"	"False"
"start_pos_settlements_onscreen_name_settlement:tripoli:tripoli108"	"Tripoli"	"False"
"start_pos_settlements_onscreen_name_settlement:tripoli:tripoli379"	"Tripoli"	"False"
"start_pos_settlements_onscreen_name_settlement:tunis:tunis109"	"Tunis"	"False"
"start_pos_settlements_onscreen_name_settlement:tunis:tunis380"	"Tunis"	"False"
"start_pos_settlements_onscreen_name_settlement:ukraine:kiev126"	"Kiev"	"False"
"start_pos_settlements_onscreen_name_settlement:ukraine:kiev383"	"Kiev"	"False"
"start_pos_settlements_onscreen_name_settlement:upper_louisiana:fort_chartres-601918574"	"Fort de Chartres"	"False"
"start_pos_settlements_onscreen_name_settlement:upper_louisiana:fort_chartres-601918574"	"St. Louis"	"False"
"start_pos_settlements_onscreen_name_settlement:upper_louisiana:fort_chartres701556085"	"Fort de Chartres"	"False"
"start_pos_settlements_onscreen_name_settlement:upper_louisiana:fort_chartres701556085"	"St. Louis"	"False"
"start_pos_settlements_onscreen_name_settlement:upper_louisiana:fort_chartres703987409"	"Fort de Chartres"	"False"
"start_pos_settlements_onscreen_name_settlement:upper_louisiana:fort_chartres703987409"	"St. Louis"	"False"
"start_pos_settlements_onscreen_name_settlement:venice:venice111"	"Venice"	"False"
"start_pos_settlements_onscreen_name_settlement:venice:venice385"	"Venice"	"False"
"start_pos_settlements_onscreen_name_settlement:virginia:williamsburg-1939761033"	"Williamsburg"	"False"
"start_pos_settlements_onscreen_name_settlement:virginia:williamsburg207"	"Richmond"	"False"
"start_pos_settlements_onscreen_name_settlement:virginia:williamsburg207"	"Williamsburg"	"False"
"start_pos_settlements_onscreen_name_settlement:virginia:williamsburg386"	"Richmond"	"False"
"start_pos_settlements_onscreen_name_settlement:virginia:williamsburg386"	"Williamsburg"	"False"
"start_pos_settlements_onscreen_name_settlement:virginia:williamsburg399"	"Jamestown"	"False"
"start_pos_settlements_onscreen_name_settlement:virginia:williamsburg399"	"Richmond"	"False"
"start_pos_settlements_onscreen_name_settlement:virginia:williamsburg416"	"Richmond"	"False"
"start_pos_settlements_onscreen_name_settlement:virginia:williamsburg416"	"Williamsburg"	"False"
"start_pos_settlements_onscreen_name_settlement:virginia:williamsburg429"	"Richmond"	"False"
"start_pos_settlements_onscreen_name_settlement:virginia:williamsburg429"	"Williamsburg"	"False"
"start_pos_settlements_onscreen_name_settlement:west_pommerania:berlin237"	"Berlin"	"False"
"start_pos_settlements_onscreen_name_settlement:west_pommerania:berlin53"	"Berlin"	"False"
"start_pos_settlements_onscreen_name_settlement:west_prussia:gdansk113"	"Gdansk"	"False"
"start_pos_settlements_onscreen_name_settlement:west_prussia:gdansk389"	"Gdansk"	"False"
"start_pos_settlements_onscreen_name_settlement:windward_islands:martinique1726133996"	"Martinique"	"False"
"start_pos_settlements_onscreen_name_settlement:windward_islands:martinique209"	"Martinique"	"False"
"start_pos_settlements_onscreen_name_settlement:windward_islands:martinique392"	"Martinique"	"False"
"start_pos_settlements_onscreen_name_settlement:windward_islands:martinique456"	"Martinique"	"False"
"start_pos_settlements_onscreen_name_settlement:wurttemberg:stuttgart115"	"Stuttgart"	"False"
"start_pos_settlements_onscreen_name_settlement:wurttemberg:stuttgart394"	"Stuttgart"	"False"